b,b,b,b,b,b,b,b,b,b,b
b,c,-,-,-,-,-,-,-,c,b
b,-,b,b,b,-,b,b,b,-,b
b,-,-,b,-,-,-,b,-,-,b
b,-,b,b,b,-,b,b,b,-,b
b,-,-,c,-,-,-,c,-,-,b
b,-,b,b,b,-,b,b,b,-,b
b,-,-,b,-,-,-,b,-,-,b
b,-,b,b,b,-,b,b,b,-,b
b,c,-,-,-,-,-,-,-,c,b
b,b,b,b,b,b,b,b,b,b,b